fra;jour;n_dose1;n_complet;n_rappel;n_cum_dose1;n_cum_complet;n_cum_rappel;couv_dose1;couv_complet;couv_rappel
FR;2020-12-27;449;51;0;449;51;0;0.0;0.0;0.0
FR;2020-12-28;474;38;0;923;89;0;0.0;0.0;0.0
FR;2020-12-29;299;16;0;1222;105;0;0.0;0.0;0.0
FR;2020-12-30;352;15;0;1574;120;0;0.0;0.0;0.0
FR;2020-12-31;284;19;0;1858;139;0;0.0;0.0;0.0
FR;2021-01-01;329;35;0;2187;174;0;0.0;0.0;0.0
FR;2021-01-02;263;29;0;2450;203;0;0.0;0.0;0.0
FR;2021-01-03;291;28;0;2741;231;0;0.0;0.0;0.0
FR;2021-01-04;1815;46;0;4556;277;0;0.0;0.0;0.0
FR;2021-01-05;5752;68;0;10308;345;0;0.0;0.0;0.0
FR;2021-01-06;11655;103;0;21963;448;0;0.0;0.0;0.0
FR;2021-01-07;29132;142;0;51095;590;0;0.1;0.0;0.0
FR;2021-01-08;36785;192;0;87880;782;0;0.2;0.0;0.0
FR;2021-01-09;11117;72;0;98997;854;0;0.2;0.0;0.0
FR;2021-01-10;5789;23;0;104786;877;0;0.2;0.0;0.0
FR;2021-01-11;39684;219;0;144470;1096;0;0.3;0.0;0.0
FR;2021-01-12;61767;312;0;206237;1408;0;0.4;0.0;0.0
FR;2021-01-13;64698;418;0;270935;1826;0;0.5;0.0;0.0
FR;2021-01-14;82298;1190;0;353233;3016;0;0.6;0.0;0.0
FR;2021-01-15;68616;580;0;421849;3596;0;0.7;0.0;0.0
FR;2021-01-16;20056;203;0;441905;3799;0;0.8;0.0;0.0
FR;2021-01-17;10868;130;0;452773;3929;0;0.8;0.0;0.0
FR;2021-01-18;85505;609;0;538278;4538;0;0.9;0.0;0.0
FR;2021-01-19;130227;848;0;668505;5386;0;1.2;0.0;0.0
FR;2021-01-20;137171;875;0;805676;6261;0;1.4;0.0;0.0
FR;2021-01-21;157782;974;0;963458;7235;0;1.7;0.0;0.0
FR;2021-01-22;120572;799;0;1084030;8034;0;1.9;0.0;0.0
FR;2021-01-23;38304;197;0;1122334;8231;0;1.9;0.0;0.0
FR;2021-01-24;9641;88;0;1131975;8319;0;2.0;0.0;0.0
FR;2021-01-25;77840;1523;0;1209815;9842;0;2.1;0.0;0.0
FR;2021-01-26;100051;3572;0;1309866;13414;0;2.3;0.0;0.0
FR;2021-01-27;106942;6295;0;1416808;19709;0;2.5;0.0;0.0
FR;2021-01-28;123979;15079;0;1540787;34788;0;2.7;0.1;0.0
FR;2021-01-29;91845;17692;0;1632632;52480;0;2.8;0.1;0.0
FR;2021-01-30;28971;4281;0;1661603;56761;0;2.9;0.1;0.0
FR;2021-01-31;5127;1692;0;1666730;58453;0;2.9;0.1;0.0
FR;2021-02-01;52371;21186;0;1719101;79639;0;3.0;0.1;0.0
FR;2021-02-02;71837;34792;0;1790938;114431;0;3.1;0.2;0.0
FR;2021-02-03;71958;37160;0;1862896;151591;0;3.2;0.3;0.0
FR;2021-02-04;81596;50301;0;1944492;201892;0;3.4;0.4;0.0
FR;2021-02-05;67911;45380;0;2012403;247272;0;3.5;0.4;0.0
FR;2021-02-06;22422;10517;0;2034825;257789;0;3.5;0.4;0.0
FR;2021-02-07;5068;5112;0;2039893;262901;0;3.5;0.5;0.0
FR;2021-02-08;46478;46003;0;2086371;308904;0;3.6;0.5;0.0
FR;2021-02-09;65645;72901;0;2152016;381805;0;3.7;0.7;0.0
FR;2021-02-10;70395;77255;0;2222411;459060;0;3.9;0.8;0.0
FR;2021-02-11;86759;100069;0;2309170;559129;0;4.0;1.0;0.0
FR;2021-02-12;78725;75209;0;2387895;634338;0;4.1;1.1;0.0
FR;2021-02-13;22116;19592;0;2410011;653930;0;4.2;1.1;0.0
FR;2021-02-14;4878;7232;0;2414889;661162;0;4.2;1.1;0.0
FR;2021-02-15;37647;76501;0;2452536;737663;0;4.3;1.3;0.0
FR;2021-02-16;49895;100810;0;2502431;838473;0;4.3;1.5;0.0
FR;2021-02-17;50050;103083;0;2552481;941556;0;4.4;1.6;0.0
FR;2021-02-18;69169;119083;0;2621650;1060639;0;4.5;1.8;0.0
FR;2021-02-19;64653;91374;0;2686303;1152013;0;4.7;2.0;0.0
FR;2021-02-20;18333;28425;0;2704636;1180438;0;4.7;2.0;0.0
FR;2021-02-21;3143;6406;0;2707779;1186844;0;4.7;2.1;0.0
FR;2021-02-22;37104;73118;0;2744883;1259962;0;4.8;2.2;0.0
FR;2021-02-23;53352;84574;0;2798235;1344536;0;4.9;2.3;0.0
FR;2021-02-24;59383;81803;0;2857618;1426339;0;5.0;2.5;0.0
FR;2021-02-25;99984;93242;0;2957602;1519581;0;5.1;2.6;0.0
FR;2021-02-26;112866;73323;0;3070468;1592904;0;5.3;2.8;0.0
FR;2021-02-27;51779;22996;0;3122247;1615900;0;5.4;2.8;0.0
FR;2021-02-28;5998;4569;0;3128245;1620469;0;5.4;2.8;0.0
FR;2021-03-01;64830;54030;0;3193075;1674499;0;5.5;2.9;0.0
FR;2021-03-02;100632;68604;0;3293707;1743103;0;5.7;3.0;0.0
FR;2021-03-03;115499;68330;0;3409206;1811433;0;5.9;3.1;0.0
FR;2021-03-04;162684;73645;0;3571890;1885078;0;6.2;3.3;0.0
FR;2021-03-05;199894;69435;0;3771784;1954513;0;6.5;3.4;0.0
FR;2021-03-06;207217;22971;0;3979001;1977484;0;6.9;3.4;0.0
FR;2021-03-07;120799;8692;0;4099800;1986176;0;7.1;3.4;0.0
FR;2021-03-08;106363;53762;0;4206163;2039938;0;7.3;3.5;0.0
FR;2021-03-09;171608;61631;0;4377771;2101569;0;7.6;3.6;0.0
FR;2021-03-10;177781;62255;0;4555552;2163824;0;7.9;3.8;0.0
FR;2021-03-11;241749;70569;0;4797301;2234393;0;8.3;3.9;0.0
FR;2021-03-12;293697;62438;0;5090998;2296831;0;8.8;4.0;0.0
FR;2021-03-13;230518;21106;0;5321516;2317937;0;9.2;4.0;0.0
FR;2021-03-14;62933;5444;0;5384449;2323381;0;9.3;4.0;0.0
FR;2021-03-15;157636;36943;0;5542085;2360324;0;9.6;4.1;0.0
FR;2021-03-16;140785;43221;0;5682870;2403545;0;9.9;4.2;0.0
FR;2021-03-17;149676;43085;0;5832546;2446630;0;10.1;4.2;0.0
FR;2021-03-18;166908;49625;0;5999454;2496255;0;10.4;4.3;0.0
FR;2021-03-19;229052;44341;0;6228506;2540596;0;10.8;4.4;0.0
FR;2021-03-20;166000;16285;0;6394506;2556881;0;11.1;4.4;0.0
FR;2021-03-21;49475;4344;0;6443981;2561225;0;11.2;4.4;0.0
FR;2021-03-22;169038;39440;0;6613019;2600665;0;11.5;4.5;0.0
FR;2021-03-23;249211;49687;0;6862230;2650352;0;11.9;4.6;0.0
FR;2021-03-24;255741;51252;0;7117971;2701604;0;12.3;4.7;0.0
FR;2021-03-25;340651;55248;0;7458622;2756852;0;12.9;4.8;0.0
FR;2021-03-26;357706;53099;0;7816328;2809951;0;13.6;4.9;0.0
FR;2021-03-27;194594;22972;0;8010922;2832923;0;13.9;4.9;0.0
FR;2021-03-28;58966;5737;0;8069888;2838660;0;14.0;4.9;0.0
FR;2021-03-29;202140;60527;0;8272028;2899187;0;14.3;5.0;0.0
FR;2021-03-30;284234;79359;0;8556262;2978546;0;14.8;5.2;0.0
FR;2021-03-31;261840;82918;0;8818102;3061464;0;15.3;5.3;0.0
FR;2021-04-01;313340;100652;0;9131442;3162116;0;15.8;5.5;0.0
FR;2021-04-02;280123;103142;0;9411565;3265258;0;16.3;5.7;0.0
FR;2021-04-03;140262;66686;0;9551827;3331944;0;16.6;5.8;0.0
FR;2021-04-04;45444;20589;0;9597271;3352533;0;16.6;5.8;0.0
FR;2021-04-05;59789;13550;0;9657060;3366083;0;16.7;5.8;0.0
FR;2021-04-06;215706;115802;0;9872766;3481885;0;17.1;6.0;0.0
FR;2021-04-07;258509;125842;0;10131275;3607727;0;17.6;6.3;0.0
FR;2021-04-08;335895;135973;0;10467170;3743700;0;18.1;6.5;0.0
FR;2021-04-09;408345;133104;0;10875515;3876804;0;18.9;6.7;0.0
FR;2021-04-10;211649;90691;0;11087164;3967495;0;19.2;6.9;0.0
FR;2021-04-11;55586;36977;0;11142750;4004472;0;19.3;6.9;0.0
FR;2021-04-12;235630;124033;0;11378380;4128505;0;19.7;7.2;0.0
FR;2021-04-13;307840;156915;0;11686220;4285420;0;20.3;7.4;0.0
FR;2021-04-14;292325;151925;0;11978545;4437345;0;20.8;7.7;0.0
FR;2021-04-15;334629;162557;0;12313174;4599902;0;21.4;8.0;0.0
FR;2021-04-16;337764;159651;0;12650938;4759553;0;21.9;8.3;0.0
FR;2021-04-17;187753;97499;0;12838691;4857052;0;22.3;8.4;0.0
FR;2021-04-18;51040;37735;0;12889731;4894787;0;22.4;8.5;0.0
FR;2021-04-19;204217;146891;0;13093948;5041678;0;22.7;8.7;0.0
FR;2021-04-20;252513;181717;0;13346461;5223395;0;23.1;9.1;0.0
FR;2021-04-21;251366;180198;0;13597827;5403593;0;23.6;9.4;0.0
FR;2021-04-22;285715;202276;0;13883542;5605869;0;24.1;9.7;0.0
FR;2021-04-23;295596;201027;0;14179138;5806896;0;24.6;10.1;0.0
FR;2021-04-24;189352;121674;0;14368490;5928570;0;24.9;10.3;0.0
FR;2021-04-25;68946;42465;0;14437436;5971035;0;25.0;10.4;0.0
FR;2021-04-26;219566;168817;0;14657002;6139852;0;25.4;10.6;0.0
FR;2021-04-27;282819;210345;0;14939821;6350197;0;25.9;11.0;0.0
FR;2021-04-28;297815;208199;1;15237636;6558396;1;26.4;11.4;0.0
FR;2021-04-29;355117;231003;0;15592753;6789399;1;27.0;11.8;0.0
FR;2021-04-30;370326;223946;1;15963079;7013345;2;27.7;12.2;0.0
FR;2021-05-01;165169;63621;0;16128248;7076966;2;28.0;12.3;0.0
FR;2021-05-02;90802;43413;0;16219050;7120379;2;28.1;12.3;0.0
FR;2021-05-03;285962;189698;0;16505012;7310077;2;28.6;12.7;0.0
FR;2021-05-04;312697;250096;0;16817709;7560173;2;29.2;13.1;0.0
FR;2021-05-05;323130;249192;0;17140839;7809365;2;29.7;13.5;0.0
FR;2021-05-06;376016;273194;0;17516855;8082559;2;30.4;14.0;0.0
FR;2021-05-07;370053;297830;0;17886908;8380389;2;31.0;14.5;0.0
FR;2021-05-08;220682;81895;0;18107590;8462284;2;31.4;14.7;0.0
FR;2021-05-09;128893;55261;0;18236483;8517545;2;31.6;14.8;0.0
FR;2021-05-10;308956;254302;0;18545439;8771847;2;32.2;15.2;0.0
FR;2021-05-11;400750;296165;0;18946189;9068012;2;32.9;15.7;0.0
FR;2021-05-12;430324;269099;0;19376513;9337111;2;33.6;16.2;0.0
FR;2021-05-13;335650;78201;0;19712163;9415312;2;34.2;16.3;0.0
FR;2021-05-14;450577;202785;0;20162740;9618097;2;35.0;16.7;0.0
FR;2021-05-15;371611;120140;0;20534351;9738237;2;35.6;16.9;0.0
FR;2021-05-16;201425;34114;0;20735776;9772351;2;36.0;16.9;0.0
FR;2021-05-17;373236;178847;0;21109012;9951198;2;36.6;17.3;0.0
FR;2021-05-18;455994;192357;0;21565006;10143555;2;37.4;17.6;0.0
FR;2021-05-19;464193;182832;0;22029199;10326387;2;38.2;17.9;0.0
FR;2021-05-20;503670;204398;0;22532869;10530785;2;39.1;18.3;0.0
FR;2021-05-21;486270;220978;0;23019139;10751763;2;39.9;18.6;0.0
FR;2021-05-22;345123;108067;0;23364262;10859830;2;40.5;18.8;0.0
FR;2021-05-23;160676;26879;0;23524938;10886709;2;40.8;18.9;0.0
FR;2021-05-24;261355;53003;0;23786293;10939712;2;41.2;19.0;0.0
FR;2021-05-25;397010;225927;0;24183303;11165639;2;41.9;19.4;0.0
FR;2021-05-26;410405;226322;0;24593708;11391961;2;42.6;19.8;0.0
FR;2021-05-27;446661;265781;0;25040369;11657742;2;43.4;20.2;0.0
FR;2021-05-28;426697;317403;0;25467066;11975145;2;44.2;20.8;0.0
FR;2021-05-29;297408;181909;0;25764474;12157054;2;44.7;21.1;0.0
FR;2021-05-30;106133;42047;0;25870607;12199101;2;44.9;21.2;0.0
FR;2021-05-31;355487;241458;0;26226094;12440559;2;45.5;21.6;0.0
FR;2021-06-01;422205;302726;0;26648299;12743285;2;46.2;22.1;0.0
FR;2021-06-02;412218;277846;0;27060517;13021131;2;46.9;22.6;0.0
FR;2021-06-03;458039;312762;0;27518556;13333893;2;47.7;23.1;0.0
FR;2021-06-04;451349;361486;0;27969905;13695379;2;48.5;23.7;0.0
FR;2021-06-05;302124;221755;0;28272029;13917134;2;49.0;24.1;0.0
FR;2021-06-06;131365;61046;0;28403394;13978180;2;49.3;24.2;0.0
FR;2021-06-07;334271;298984;0;28737665;14277164;2;49.8;24.8;0.0
FR;2021-06-08;389557;337523;0;29127222;14614687;2;50.5;25.3;0.0
FR;2021-06-09;380228;319872;0;29507450;14934559;2;51.2;25.9;0.0
FR;2021-06-10;398047;338388;0;29905497;15272947;2;51.9;26.5;0.0
FR;2021-06-11;383503;407116;0;30289000;15680063;2;52.5;27.2;0.0
FR;2021-06-12;281028;243090;0;30570028;15923153;2;53.0;27.6;0.0
FR;2021-06-13;103772;84879;0;30673800;16008032;2;53.2;27.8;0.0
FR;2021-06-14;237870;384432;0;30911670;16392464;2;53.6;28.4;0.0
FR;2021-06-15;304338;424096;1;31216008;16816560;3;54.1;29.2;0.0
FR;2021-06-16;310250;395014;0;31526258;17211574;3;54.7;29.8;0.0
FR;2021-06-17;314194;412780;0;31840452;17624354;3;55.2;30.6;0.0
FR;2021-06-18;318792;485375;1;32159244;18109729;4;55.8;31.4;0.0
FR;2021-06-19;222793;300676;0;32382037;18410405;4;56.1;31.9;0.0
FR;2021-06-20;73221;111472;0;32455258;18521877;4;56.3;32.1;0.0
FR;2021-06-21;193028;427423;0;32648286;18949300;4;56.6;32.9;0.0
FR;2021-06-22;220568;499354;2;32868854;19448654;6;57.0;33.7;0.0
FR;2021-06-23;231070;473581;0;33099924;19922235;6;57.4;34.5;0.0
FR;2021-06-24;239167;446378;0;33339091;20368613;6;57.8;35.3;0.0
FR;2021-06-25;224313;560807;0;33563404;20929420;6;58.2;36.3;0.0
FR;2021-06-26;151637;395168;0;33715041;21324588;6;58.5;37.0;0.0
FR;2021-06-27;55044;165007;0;33770085;21489595;6;58.6;37.3;0.0
FR;2021-06-28;152596;478331;0;33922681;21967926;6;58.8;38.1;0.0
FR;2021-06-29;180619;537418;0;34103300;22505344;6;59.1;39.0;0.0
FR;2021-06-30;201488;515941;3;34304788;23021285;9;59.5;39.9;0.0
FR;2021-07-01;224886;498093;1;34529674;23519378;10;59.9;40.8;0.0
FR;2021-07-02;223045;563293;3;34752719;24082671;13;60.3;41.8;0.0
FR;2021-07-03;140069;395397;2;34892788;24478068;15;60.5;42.4;0.0
FR;2021-07-04;55901;150955;0;34948689;24629023;15;60.6;42.7;0.0
FR;2021-07-05;164373;449800;5;35113062;25078823;20;60.9;43.5;0.0
FR;2021-07-06;193530;512035;9;35306592;25590858;29;61.2;44.4;0.0
FR;2021-07-07;208751;478118;5;35515343;26068976;34;61.6;45.2;0.0
FR;2021-07-08;228406;468561;1;35743749;26537537;35;62.0;46.0;0.0
FR;2021-07-09;225964;556641;1;35969713;27094178;36;62.4;47.0;0.0
FR;2021-07-10;146689;368725;0;36116402;27462903;36;62.6;47.6;0.0
FR;2021-07-11;59340;121013;0;36175742;27583916;36;62.7;47.8;0.0
FR;2021-07-12;166457;513403;3;36342199;28097319;39;63.0;48.7;0.0
FR;2021-07-13;284588;587123;3;36626787;28684442;42;63.5;49.7;0.0
FR;2021-07-14;178748;186959;0;36805535;28871401;42;63.8;50.1;0.0
FR;2021-07-15;343791;572666;1;37149326;29444067;43;64.4;51.1;0.0
FR;2021-07-16;377227;575510;1;37526553;30019577;44;65.1;52.1;0.0
FR;2021-07-17;258072;368901;1;37784625;30388478;45;65.5;52.7;0.0
FR;2021-07-18;108983;133423;0;37893608;30521901;45;65.7;52.9;0.0
FR;2021-07-19;283171;480378;2;38176779;31002279;47;66.2;53.8;0.0
FR;2021-07-20;374200;525280;0;38550979;31527559;47;66.8;54.7;0.0
FR;2021-07-21;393060;483060;2;38944039;32010619;49;67.5;55.5;0.0
FR;2021-07-22;438121;472746;2;39382160;32483365;51;68.3;56.3;0.0
FR;2021-07-23;436228;510781;3;39818388;32994146;54;69.0;57.2;0.0
FR;2021-07-24;284047;322309;0;40102435;33316455;54;69.5;57.8;0.0
FR;2021-07-25;120350;100336;0;40222785;33416791;54;69.7;57.9;0.0
FR;2021-07-26;345410;386107;2;40568195;33802898;56;70.3;58.6;0.0
FR;2021-07-27;461201;401379;3;41029396;34204277;59;71.1;59.3;0.0
FR;2021-07-28;456532;367381;1;41485928;34571658;60;71.9;59.9;0.0
FR;2021-07-29;486759;357367;1;41972687;34929025;61;72.8;60.6;0.0
FR;2021-07-30;459219;381193;3;42431906;35310218;64;73.6;61.2;0.0
FR;2021-07-31;284130;231276;0;42716036;35541494;64;74.1;61.6;0.0
FR;2021-08-01;110638;65618;0;42826674;35607112;64;74.3;61.7;0.0
FR;2021-08-02;336797;284775;1;43163471;35891887;65;74.8;62.2;0.0
FR;2021-08-03;393609;305102;0;43557080;36196989;65;75.5;62.8;0.0
FR;2021-08-04;381392;265823;0;43938472;36462812;65;76.2;63.2;0.0
FR;2021-08-05;362774;281766;0;44301246;36744578;65;76.8;63.7;0.0
FR;2021-08-06;356722;327151;0;44657968;37071729;65;77.4;64.3;0.0
FR;2021-08-07;211173;209802;1;44869141;37281531;66;77.8;64.6;0.0
FR;2021-08-08;73265;73474;0;44942406;37355005;66;77.9;64.8;0.0
FR;2021-08-09;256095;298366;3;45198501;37653371;69;78.4;65.3;0.0
FR;2021-08-10;303006;324667;1;45501507;37978038;70;78.9;65.9;0.0
FR;2021-08-11;276668;302496;1;45778175;38280534;71;79.4;66.4;0.0
FR;2021-08-12;268931;320588;0;46047106;38601122;71;79.8;66.9;0.0
FR;2021-08-13;249848;314188;1;46296954;38915310;72;80.3;67.5;0.0
FR;2021-08-14;144068;219823;0;46441022;39135133;72;80.5;67.9;0.0
FR;2021-08-15;37933;55596;1;46478955;39190729;73;80.6;68.0;0.0
FR;2021-08-16;184073;346485;0;46663028;39537214;73;80.9;68.6;0.0
FR;2021-08-17;213601;370131;2;46876629;39907345;75;81.3;69.2;0.0
FR;2021-08-18;196798;355182;2;47073427;40262527;77;81.6;69.8;0.0
FR;2021-08-19;190076;356221;1;47263503;40618748;78;82.0;70.4;0.0
FR;2021-08-20;184120;395746;1;47447623;41014494;79;82.3;71.1;0.0
FR;2021-08-21;103783;254454;0;47551406;41268948;79;82.5;71.6;0.0
FR;2021-08-22;31519;92125;1;47582925;41361073;80;82.5;71.7;0.0
FR;2021-08-23;139545;379813;2;47722470;41740886;82;82.7;72.4;0.0
FR;2021-08-24;160922;403504;1;47883392;42144390;83;83.0;73.1;0.0
FR;2021-08-25;149159;376038;3;48032551;42520428;86;83.3;73.7;0.0
FR;2021-08-26;141170;368096;8;48173721;42888524;94;83.5;74.4;0.0
FR;2021-08-27;146604;415136;7;48320325;43303660;101;83.8;75.1;0.0
FR;2021-08-28;89772;265388;0;48410097;43569048;101;83.9;75.5;0.0
FR;2021-08-29;26871;88286;1;48436968;43657334;102;84.0;75.7;0.0
FR;2021-08-30;115857;341608;6257;48552825;43998942;6359;84.2;76.3;0.0
FR;2021-08-31;127497;353269;12088;48680322;44352211;18447;84.4;76.9;0.0
FR;2021-09-01;130745;301594;23865;48811067;44653805;42312;84.6;77.4;0.1
FR;2021-09-02;106915;261844;28552;48917982;44915649;70864;84.8;77.9;0.1
FR;2021-09-03;115658;308903;32727;49033640;45224552;103591;85.0;78.4;0.2
FR;2021-09-04;88558;230091;13910;49122198;45454643;117501;85.2;78.8;0.2
FR;2021-09-05;20901;48337;4674;49143099;45502980;122175;85.2;78.9;0.2
FR;2021-09-06;72327;190810;34003;49215426;45693790;156178;85.3;79.2;0.3
FR;2021-09-07;75282;191003;35610;49290708;45884793;191788;85.5;79.6;0.3
FR;2021-09-08;86502;216261;32026;49377210;46101054;223814;85.6;79.9;0.4
FR;2021-09-09;73516;173785;35562;49450726;46274839;259376;85.7;80.2;0.4
FR;2021-09-10;93010;214385;39595;49543736;46489224;298971;85.9;80.6;0.5
FR;2021-09-11;65359;177701;13961;49609095;46666925;312932;86.0;80.9;0.5
FR;2021-09-12;12401;34096;3076;49621496;46701021;316008;86.0;81.0;0.5
FR;2021-09-13;62950;134313;43130;49684446;46835334;359138;86.2;81.2;0.6
FR;2021-09-14;71583;135958;60417;49756029;46971292;419555;86.3;81.4;0.7
FR;2021-09-15;73956;173949;53800;49829985;47145241;473355;86.4;81.7;0.8
FR;2021-09-16;62477;117131;58951;49892462;47262372;532306;86.5;82.0;0.9
FR;2021-09-17;73701;158932;56297;49966163;47421304;588603;86.6;82.2;1.0
FR;2021-09-18;47529;143599;17091;50013692;47564903;605694;86.7;82.5;1.1
FR;2021-09-19;7639;24886;2588;50021331;47589789;608282;86.7;82.5;1.1
FR;2021-09-20;42312;95866;49204;50063643;47685655;657486;86.8;82.7;1.1
FR;2021-09-21;44782;98071;62016;50108425;47783726;719502;86.9;82.9;1.2
FR;2021-09-22;47421;143189;53886;50155846;47926915;773388;87.0;83.1;1.3
FR;2021-09-23;42140;89663;61797;50197986;48016578;835185;87.0;83.3;1.4
FR;2021-09-24;51372;130553;58066;50249358;48147131;893251;87.1;83.5;1.5
FR;2021-09-25;34512;117530;18054;50283870;48264661;911305;87.2;83.7;1.6
FR;2021-09-26;5226;18577;2264;50289096;48283238;913569;87.2;83.7;1.6
FR;2021-09-27;33405;78277;47421;50322501;48361515;960990;87.3;83.9;1.7
FR;2021-09-28;35695;73320;55562;50358196;48434835;1016552;87.3;84.0;1.8
FR;2021-09-29;43530;102034;53596;50401726;48536869;1070148;87.4;84.2;1.9
FR;2021-09-30;35462;68756;58180;50437188;48605625;1128328;87.5;84.3;2.0
FR;2021-10-01;56208;97156;62638;50493396;48702781;1190966;87.6;84.4;2.1
FR;2021-10-02;37417;80763;23125;50530813;48783544;1214091;87.6;84.6;2.1
FR;2021-10-03;4985;11289;2506;50535798;48794833;1216597;87.6;84.6;2.1
FR;2021-10-04;31817;58461;54113;50567615;48853294;1270710;87.7;84.7;2.2
FR;2021-10-05;31475;61490;63739;50599090;48914784;1334449;87.7;84.8;2.3
FR;2021-10-06;40518;79255;67339;50639608;48994039;1401788;87.8;85.0;2.4
FR;2021-10-07;29239;58450;67510;50668847;49052489;1469298;87.9;85.1;2.5
FR;2021-10-08;45747;88923;83621;50714594;49141412;1552919;87.9;85.2;2.7
FR;2021-10-09;32842;63428;33516;50747436;49204840;1586435;88.0;85.3;2.8
FR;2021-10-10;4036;7501;3369;50751472;49212341;1589804;88.0;85.3;2.8
FR;2021-10-11;28454;49883;63422;50779926;49262224;1653226;88.0;85.4;2.9
FR;2021-10-12;29705;50584;74675;50809631;49312808;1727901;88.1;85.5;3.0
FR;2021-10-13;38381;61853;78512;50848012;49374661;1806413;88.2;85.6;3.1
FR;2021-10-14;28920;49020;72732;50876932;49423681;1879145;88.2;85.7;3.3
FR;2021-10-15;42592;68979;102190;50919524;49492660;1981335;88.3;85.8;3.4
FR;2021-10-16;30382;46251;39396;50949906;49538911;2020731;88.3;85.9;3.5
FR;2021-10-17;3701;5671;3611;50953607;49544582;2024342;88.4;85.9;3.5
FR;2021-10-18;26193;40526;70933;50979800;49585108;2095275;88.4;86.0;3.6
FR;2021-10-19;25707;40479;81029;51005507;49625587;2176304;88.4;86.0;3.8
FR;2021-10-20;33460;50745;100740;51038967;49676332;2277044;88.5;86.1;3.9
FR;2021-10-21;24533;40977;88002;51063500;49717309;2365046;88.5;86.2;4.1
FR;2021-10-22;35901;58155;111718;51099401;49775464;2476764;88.6;86.3;4.3
FR;2021-10-23;25860;40948;48302;51125261;49816412;2525066;88.6;86.4;4.4
FR;2021-10-24;2738;4949;3849;51127999;49821361;2528915;88.7;86.4;4.4
FR;2021-10-25;24854;34507;86001;51152853;49855868;2614916;88.7;86.4;4.5
FR;2021-10-26;22818;31697;91448;51175671;49887565;2706364;88.7;86.5;4.7
FR;2021-10-27;28981;43171;113868;51204652;49930736;2820232;88.8;86.6;4.9
FR;2021-10-28;22236;30251;93443;51226888;49960987;2913675;88.8;86.6;5.1
FR;2021-10-29;30198;45225;124193;51257086;50006212;3037868;88.9;86.7;5.3
FR;2021-10-30;19514;32323;53013;51276600;50038535;3090881;88.9;86.8;5.4
FR;2021-10-31;2295;3888;3789;51278895;50042423;3094670;88.9;86.8;5.4
FR;2021-11-01;1909;4017;3094;51280804;50046440;3097764;88.9;86.8;5.4
FR;2021-11-02;22784;35560;98729;51303588;50082000;3196493;89.0;86.8;5.5
FR;2021-11-03;27342;42568;124703;51330930;50124568;3321196;89.0;86.9;5.8
FR;2021-11-04;21898;30915;113142;51352828;50155483;3434338;89.0;87.0;6.0
FR;2021-11-05;30058;44331;150065;51382886;50199814;3584403;89.1;87.0;6.2
FR;2021-11-06;20156;32393;67700;51403042;50232207;3652103;89.1;87.1;6.3
FR;2021-11-07;2098;4312;5483;51405140;50236519;3657586;89.1;87.1;6.3
FR;2021-11-08;18529;31065;132675;51423669;50267584;3790261;89.2;87.2;6.6
FR;2021-11-09;20823;33010;169991;51444492;50300594;3960252;89.2;87.2;6.9
FR;2021-11-10;29253;43549;196573;51473745;50344143;4156825;89.3;87.3;7.2
FR;2021-11-11;3123;5412;13142;51476868;50349555;4169967;89.3;87.3;7.2
FR;2021-11-12;27309;41854;195069;51504177;50391409;4365036;89.3;87.4;7.6
FR;2021-11-13;19373;28554;85503;51523550;50419963;4450539;89.3;87.4;7.7
FR;2021-11-14;2102;3709;7729;51525652;50423672;4458268;89.3;87.4;7.7
FR;2021-11-15;18864;29053;168655;51544516;50452725;4626923;89.4;87.5;8.0
FR;2021-11-16;21798;28862;210580;51566314;50481587;4837503;89.4;87.5;8.4
FR;2021-11-17;27889;37147;207431;51594203;50518734;5044934;89.5;87.6;8.7
